#############################################################################################################
########################################################################**###################################
#######################################################################****##################################
#######################################################################****************######################
#############*********################################################*****************######################
############*****************####*****###******######################******************######################
###########****************************************#################*******************######################
##########******####********************************######**########*******************######################
##########****###************************************###*****#########**##*************######################
##########****##*****#####**###********###*****###************########**###********##########################
#########****#******######**#####******####****####***********#######***#####******##########################
########***********#######**######*************####**###******#######***#####********########################
########**********#####******######*****##*****###########*****######***#####*********#######################
#########**********###*********####*****###**********#####******#####*****###*********#######################
########********#####**********#####***###***********#####*******####******##*******#########################
########****#######************#####**####****####***######*******##******###****############################
########*****#####**************####*####*****##*#****#####**************####****############################
#########**************************####******###*#****#######************####***##**#########################
#########**************************###******#**#*#********######*********####***##***########################
##########*************************##******#*####**********######********####*********#######################
##########******##*************************#####*****####*******##*******##***********#######################
#########*****####*************************###******#####*********###*****##**********#######################
#########*****####****************###******##******#######*********##*****##**********#######################
########******#####**************#####**************#######***************###*********#######################
########***#########*************####*************************************####********#######################
#######****###########********####*###************************************####********#######################
#######*****######***###****#####**##*###*************************#####*****##*******########################
#######****************##*************##################################*************########################
#######*******************************##******************************###***********#########################
########***************************************************************##**********##########################
########********####********###*****#**********************************#####****#############################
########****#########*******####****#**********************####********######################################
########*****##***#####****#####***************###********######*******######################################
########***********####*****###****#***********###*******########******######################################
########************###*****##*****#*********########****########******######################################
########*************************##**********########******##*##*******######################################
########*************************##***********###*##********#********########################################
########************#*#*************************#***********#*******########************#####################
########****#####****###************************##*********###******########************#####################
########****####***#####***********************###**********#*******#######****************##################
#########*****###**#####********************************************######******************#################
#######*******#######*##****###########****************************######*******************#################
#####**********#####********###########*******************#####***######****########**********###############
#####**********###******************#********************#######**#####*****#*******#*********###############
#####**********##*****************####******************#######***#####****#*********##*******###############
#####**********##*****************###*******************#######***####****#***********#*******###############
#####***********##*************######********************###*##***#########***********#*******###############
######**********##*************######**********************#******#####***************#*******###############
######*********###**************######********************###*****#####***************#*******###############
######*********####***********########********************##*#*****#########**********#*******###############
######**********###***********######***********************#*****#######***#*********#*******###############
#####***********###***********########***************************#######***##*********#*******###############
#####**********###************########**************************************###*******#*****#################
#######********##*************#########****************************************#***####****##################
##########*****##**************########****************************************#####**#***###################
###########****##*************#########**********##*****#********************************###**###############
###########****##***************#****************##*****#**********#####***********************##############
###########****#*******************************####*****###********#####************************#############
###########***************************#********####*****###*********####****######***************############
###########*******************####################*******###############**##########*****#**********#########
#########*********************#############********************########***##########*****##************######
#########*********************#############********************######*****#########*******#************######
#########*********************#############********************######*******#####*********##***********######
########**********************#############********************######*******#####**********#***********######
#######**********************##############********************########*****#####**********###*********######
#######**********####*******###############****#***********##**########******####************####*******#####
#######********######******################****#***********##**#########******###**************###******#####
########*******######*****#################****#***********##**#########********###**************#******#####
#########*******#####***###################****#***********##**###########*******##****####******#******#####
#########*******####***####################****#***********##**############******##****####******#******#####
#########*******####***############*****###****#***********##**#############******##***####******#******#####
##########******####***############*****###****#***********##**#############******##*****##*****##******#####
###########***########*############*****###****#***********##**###############****###***********#*******#####
##########*****#######*############*****###****#***********##**###############*****##*********###*******#####
##########****########*############************#***********##**################*****##********#*********#####
##########***########**############************#***********##**################*****###*******#********######
##########****######***############*****####***#***********##**###*******######*****####******#********######
##########****######***############*****####***#***********##**###*******######*****###******##********######
###########****####****#####################***#***********##**###*******######*****###******##********######
############***********#####################***#**#######**##**###*******######*****###******##*********#####
############*********##################*####***####****######**###*******######*****###******##*********#####
#############*******###############*****####*******************###*******######*****###******##**********####
##############******###############*******#******************************######*****###******##**********####
##############*****#########**************#**************************##########*****###******##**********####
##############****##########**************#*******************#####**##########******##******##**********####
#############*****##########**###****###**#******************######********#####*****##******##**********####
############******##########**###***##**########**#######**########********#####*****##******##**********####
###########********#########********##**########**#######**######*******#**#####*****##****###***********####
##########*****#***#########********##**########**#######**######*******#**#####*****##****##**********######
#########*****##***##############****###**######**#######**######*******#**#####***********##*********#######
#########****####***#############*********###****************####*******#**######**********##*******#########
########*****####***#############****###**###***************************#**######**********##*******#########
########*****####***########********######*##*****#######******************######*********###******##########
########*****####***########********##**##*##*****#######****####**********######******************##########
#########****####***########**###***##**##*##*****#######****####*****###########*****************###########
#########****###****########**###****###**********#######****####*****###########****************############
#########****###****########*********************************######***###########**************##############
#########****###****########**************####***************######********######*************###############
#########****####***###############*******##########****#########**********######************################
##########***###****###############*******##########****#########*******#**######************################
##########****##****##################**############****#########*******#**######*********###################
##########****##****##################**############****#########*******#**######************################
##########****#********###############**######***************####*******#**######************################
##########*************#############*************************####*******#**######************################
########****************#####********************************####**********#######***********################
########****************#####********************************####**********#######***********################
########****************#####*************####***************#####***##############*******###################
########****************############******####***********************##############*#*****###################
#######****************#############******####***#########***********########################################
#######*****************##############**#######**#########***********########################################
#######*****************##############**#######**#########**######***######*******###########################
#######****************###############**#######**#########**######***###************#########################
#######*****************##############**#######*************######***###************#########################
########***************###############**######******************#****#****************#######################
#########**************###############**####********************#**********#####******#######################
#########***************###################*********************#**********#####******#######################
##########***************##################*********************#**********#####******#######################
###########**************##################*********************#**********#####******#######################
###########*****####*****##################**###***********###**#**********#####******#######################
############***#####*****##################**#####*******#####**#**********#####******#######################
######################***##################**#####*******#####**##*********#####******#######################
#####################****##################**###***********###**########**************#######################
######################***##################*********************########**************#######################
#####################****#####****#########*********************##########********###########################
#####################***#####*****#########**###***********###**##########********###########################
#####################***####*******########**#####*******#####**#############################################
#####################***#**#***********####**#####*******#####**#############################################
#####################******************####**###***********###**#############################################
#####################****************######*********************#############################################
#####################***************#######*********************#############################################
####################****************#######**####**********###**#############################################
##################*******************######**#####*******#####**#############################################
##################*******************######**####********#####**#############################################
##################*******************######**####**********###**#############################################
####################****************#######**********************############################################
#######################**************######**********************############################################
######################***************######**********************############################################
######################****************#####**********************############################################
#####################********************************************############################################
############################*************************************############################################
###########################################**********************############################################
###########################################**####***#****######**############################################
#################################################**#####*####################################################
#################################################**#####*####################################################
#################################################**#####*####################################################
#################################################********####################################################
##################################################******#####################################################
#############################################################################################################
#############################################################################################################
#############################################################################################################
#############################################################################################################
#############################################################################################################
